Amaarae - THE ANGEL YOU DON'T KNOW (Platoon)
Aminé - Limbo (Republic)
Angelica Garcia - Cha Cha Palace (Spacebomb)
Cassowary - Cassowary (Fat Possum)
Daniel Blumberg - On&On (Mute)
Dua Lipa - Future Nostalgia (Warner)
DUCKWRTH - SuperGood (Republic)
Duval Timothy - Help (Carrying Colour)
Eartheater - Phoenix: Flames Are Dew Upon My Skin (PAN)
Ela Minus - acts of rebellion (Domino)
Eyeliner - Drop Shadow (Orange Milk)
Four Tet - Sixteen Oceans (Text)
Heavy-K - Khusta (DrumbossMusik)
Il Quadro di Troisi - Il Quadro di Troisi (raster)
Jessy Lanza - All The Time (Hyperdub)
keiyaA - Forever, Ya Girl (Forever Recordings)
Kllo - Maybe We Could (Ghostly International)
LA Priest - GENE (Domino)
Las Kellies - Suck This Tangerine (Fire)
Maajo - Kuru Kuru (Queen Nanny)
Mk.gee - A Museum Of Contradiction (IAMSOUND/Interscope)
Moses Boyd - Dark Matter (Exodus)
Oklou - Galore (True Panther)
OTTO - Clam Day (PLZ Make It Ruins)
Pantayo - Pantayo (Telephone Explosion)
Peggy Sue - Vices (French Exit)
Salaam Remi - Black On Purpose (Louder Than Life)
Sevdaliza - Shabrang (Twisted Elegance)
Shabaka and the Ancestors - We Are Sent Here By History (Impulse!)
Space Afrika - hybtwibt? (self-released)
Sufjan Stevens - The Ascension (Asthmatic Kitty)
Sweeping Promises - Hunger For A Way Out (Feel It)
The 1975 - Notes On An Unconditional Form (Dirty Hit)
The Avalanches - We Will Always Love You (Astralwerks)
The Microphones - Microphones In 2020 (P.W. Elverum & Sun, Ltd.)
Thundercat - It Is What It Is (Brainfeeder)
TOPS - I Feel Alive (Musique TOPS)
Westerman - Your Hero Is Not Dead (Partisan)
Woods - Strange To Explain (Woodsist)
Zora Jones - Ten Billion Angels (Fractal Fantasy)
Baronhawk Poitier - Temperado Tornado (Honey Soundsystem)
Bullion - We Had A Good Time (Deek Recordings) | Heaven Is Over (Friends Of/Jagjaguwar)
Denzel Curry x Kenny Beats - Unlocked (Loma Vista Recordings)
Dianna Lopez - Shapeshifting (La Luna Recordings)
Galdre Visions - Galdre Vision (Leaving)
Guedra Guedra - Son Of Sun (On The Corner)
Klein Zage - Tip Me Baby One More Time (Orphan.)
Love Mansuy - (món swee) side A | (món swee) side B (Love & Company)
Stas THEE Boss - Sang Stasia! (LucidHaus)
Yawning Portal - Heart & Earth (PLZ Make It Ruins)