LCD Soundsystem - “Movement”
Sonic Youth - Z) Eliminator Jr."
Sleigh Bells - A/B Machines"
Parquet Courts - "Wide Awake"
Cymbals Eat Guitars - XR"
The Velvet Underground - Run Run Run"
Grimes - Kill V. Maim"
Pavement - Baptiss Blacktick"
Cloud Nothings - Stay Useless"
Mission of Burma - "That's How I Escaped My Certain Fate"
The Raveonettes - "Junko Ozawa"
The Replacements - "Bastards of Young"
Silversun Pickups - "Panic Switch"
Radiohead - "Idioteque"
Fugazi - "Waiting Room"
Sleater-Kinney - "Dig Me Out"
Pixies - "Break My Body"
The Men - "Pearly Gates"
Miike Snow - "Paddling Out"
Surfer Blood - "Swim"
Hüsker Dü - "New Day Rising"
M83 - "Midnight City"
Lighting Bolt - "Assassins"
PUP - "Old Wounds"
Gil Scott-Heron, Jamie xx - "Running"
TV On The Radio - "Wolf Like Me"
Sebadoh - "License to Confuse"
At the Drive In - "Enfilade"
Gossip - "Heavy Cross"
Klaxons - "Golden Skans"
Guided By Voices - "Cut-Out Witch"
Death Grips - "I Break Mirrors With My Face in the United States"
Death From Above 1979 - "Romantic Rights"
Gang of Four - "Damaged Goods"
Iceage - "Abundant Living"
Modest Mouse - "Doin' the Cockroach"
Arctic Monkeys - "I Bet You Look Good on the Dancefloor"
The Walkmen - "The Rat"
The Strokes - "Last Nite"
Fucked Up - "Queen of Hearts"
Interpol - "Slow Hands"
Jay Reatard - "My Shadow"
Titus Andronicus - "Titus Andronicus vs. The Absurd Universe (3rd Round KO)"
The Flaming Lips - "Race for the Prize"
The Hold Steady - "Constructive Summer"
The Black Keys - "Set You Free"
Mas Ysa - "Arrows"
CHVRCHES - "Gun"
Black Joe Lewis & The Honeybears - "Booty City"
Dean Ween Group - "Exercise Man"
